111111111111111111
100000000000000001
1P001C1000000000E1
111111111111111111