111111111111111111
100000000000000001
100000000000000001
1000000C0000000001
100000000000000001
100000000000000001
1P000C0000000000E1
111111111111111111