111111111111111111
100000000000000001
1P001C100000000001
111011111111110111
100000000000000001
110111111101111111
100000000000000001
10001C1000000000E1
111111111111111111