1111111111111111111111
1111000001111100001111
1110000000110000000111
1100000000000000000011
1P000001100E1100000001
1000001010010010000001
1000010010000010000001
1100011110000100000011
1110000010001000000111
1111000010011110001111
1111100000000000011111
1111110000000000111111
1111111000000001111111
1111111100000011111111
1111111110CC0111111111
1111111111111111111111