11111111
10C010E1
11000001
1P000001
11111111
11111111