11111111
10C0100E
11000001
1P111111