1111111
1P10001
1001001
100C001
1C00001
1000E01
1111111