11111111111
1P10C010C01
10101010101
10101010101
10101010101
10101010101
10101010101
10C010C01E1
11111111111