111111111
1P010C011
100001001
100100001
1C1E010C1
111111111